R 1500 1000
F 225, 180, 65
C 65, 180, 225
NO ./brick_dark.xpm
SO ./brick_gray.xpm
WE ./brick_brown.xpm
EA ./brick_brown_vines.xpm
S ./large_box.xpm
  1111111
  1212101
  1011101
  101 101
 11011101
100222001
100N0011
1200001
1111111
