R 1500 1000
F 50,100,50
C 100,50,100
NO ./path_to_the_north_texture
SO ./path_to_the_south_texture
WE ./path_to_the_west_texture
EA ./path_to_the_east_texture
S ./path_to_the_sprite_texture
  1111111
  1010101
  1011101
  101 101
 11011101
100000001
100E0011
1000001
1111111
