R   500        500
    NO    ./path_to_the_north_texture  

SO ./path_to_the_south_texture
     WE 	./path_to_the_west_texture		 
EA ./path_to_the_east_texture

	S ./path_to_the_sprite_texture    	
F 220,100,0


C 225,30,00

1111111111111111111111111111
10000000001100000000000000001
10110000011100000020000010011111
11111001000000000000000001001
11011000001110000000000001111
10000000000110000011100000101
11110111111111011100000010011
11110111111111011101010010001
1000000110101011100000010001
10002000000000001100000010001
10000000000000001101010010001
11000000110101011111011110N01
11110111111101011111011110001
1111111111111111111111111111