R  901        751
    NO    ./path_to_the_north_texture  

SO ./path_to_the_south_texture
     WE 	./path_to_the_west_texture		 
EA ./path_to_the_east_texture

	S ./path_to_the_sprite_texture    	
F 50,100,     50


C 100,      50,100

1111111
1010101
1000001
1000001
100N001
1000001
111111