R 1500 1000
F 225, 180, 65
C 65, 180, 225
NO ./brick_dark0.XPM
SO ./brick_gray0.XPM
WE ./brick_brown0.XPM
EA ./brick_brown-vines1.XPM
S ./grape.XPM
  1111111
  1010101
  1011101
  101 101
 11011101
100000001
100N0011
1000001
1111111
