R  750        750
    NO    ./path_to_the_north_texture  

SO ./path_to_the_south_texture
     WE 	./path_to_the_west_texture		 
EA ./path_to_the_east_texture

	S ./path_to_the_sprite_texture    	
F 220,100,     42


C 225,      142,00

1111111
1010101
1000001
1000001
100N001
1000001
111111