R 1500 1000
F 225,    180, 65
C 65,   180,   225
NO      	./brick_dark.xpm
SO 	./brick3.xpm




WE ./brick1.xpm

EA 	./brick2.xpm
S ./large_box.xpm

        1111111111111111111111111
        1000000000110000000000001
        1011000001110000002000001
        1201000000000000000000001
111111111011000001110000000000001
120000000011000001110111111111111
11110111111111011100000010001
11110111111111011101010000001
11000000110101011100000010001
10002000000000001100001110001
10000000000000000001010030001
11000001110101011100011110N0111
11112111 1110101 121111010201
11111111 1111111 111111111111
